000000000000000000000000000000000000000000000000000000000000000000000000000000000000000000000000000000000000000000000000000000000000000000000000000000000000000000000000000000000000
0**********************************************************************************************************************************************************************************0
0*********************************D************************************************************************************************************************************************0
0**********************************************************************************************************************************************************************************0
0**********************************************************************************************************************************************************************************0
0**********************************************************************************************************************************************************************************0
0**********************************************************************************************************************************************************************************0
0**********************************************************************************************************************************************************************************0
0**********************************************************************************************************************************************************************************0
0**********************************************************************************************************************************************************************************0
0**********************************************************************************************************************************************************************************0
0**********************************************************************************************************************************************************************************0
0**********************************************************************************************************************************************************************************0
0*********************************************************************************************ggggg**********************************************************1*********************0
0************************************************************************************************************************************************************1*********************0
0****************************************************************************************D*B****D************************************************************1***P*****************0
0*********************************************************************************M*wwwwwwww*******B*ww******************************************************1*********************0
0*******************************************************************gggggggggggggggggg*****gggggggggggww*****************************************************1*********************0
0*********************************c*********************************oooooooooooooooooo*****ooooooooooooww**********ggggg*************************************1********************d0
0*s*************D*************************************************M*oooooooooooooooooo*****oooooooooooooww*********oooooM***********c************************1*********************0
0********************************bbb****************D***b*******ggggoooooooooooooooooo*****ooooooooooooooogggg*****oooggggg**********************************1*********************0
0ggggggggggggggggggggggggggggggggggggggggggggggggggggggggggggggggggggggooooooooooooooo*****ooooooooooooooo*********oooooggg****gggggggggggggggggggggggggggggggggggggggggggggggggggg0
00000000000000000000000000000000000000000000000000000000000000000000000000000000000000*****0000000000000000000*****00000000****00000000000000000000000000000000000000000000000000000
0**********************************************************************************************************************************************************************************0
0**********************************************************************************************************************************************************************************0
0***************************************************************************************T***********************T******************************************************************0
0**********************************************************************************************************************************************************************************0
0**********************************************************************************************************************************************************************************0
0**********************************************************************************************************************************************************************************0
0*************************************************************************************000000*******************000*****************************************************************0
