0000000000000000000000000000000000000000000000000000000000000000000000000000000000000000000000000000000000000000000000000000000000000000000000000000
0**************************************************************************************************************************************************0
0**************************************************************************************************************************************************0
0**********************D******************************A*********************D************D************A********************************************0
0**************************************************************************************************************************************************0
0**************************************************************************************************************************************************0
0**************************************************************************************************************************************************0
0**************************************************************************************************************************************************0
0**************************************************************************************************************************************************0
0**************************************************************************************************************************************************0
0**************************************************************************************************************************************************0
0**************************************************************************************************************************************************0
0**************************************************************************************************************************************************0
0**************************************************************************************************************************************************0
0**************************************************************************************************************************************************0
0************************************************bbbbb*********************************************************************************************0
0************************************************b***b*********************************************************************************************0
0************************************************b***b*********************************************************************************************0
0*****************************bbbbb**************b***b***********************************************M********************************************d0
0******s**********************b***b**************b***b**********************************************bbb*********bbb*****************c**************0
0*****************************b***b*****B********b***b*********************************************bbbb*********bbbb**************B****************0
0gggggggggggggggggggggggggggggggggggggggggggggggggggggggggggggggggggggggggggggggggggggggggggggggggggggg*********ggggggggggggggggggggggggggggggggggggg
0000000000000000000000000000000000000000000000000000000000000000000000000000000000000000000000000000000*********00000000000000000000000000000000000gg
0**************************************************************************************************************************************************0
0**************************************************************************************************************************************************0
0**********************************************************************************************************T***************************************0
0**************************************************************************************************************************************************0
0**************************************************************************************************************************************************0
0**************************************************************************************************************************************************0
0*******************************************************************************************************00000000***********************************0
