0000000000000000000000000000000000000000000000000000000000000000000000000000000000000000000000000000000000000000000000000000000000000000000000000000
0**************************************************************************************************************************************************0
0*****************************************************************D********************************************************************************0
0**********************D*****************************************************************D*********************************************************0
0***********************************************D**************************************************************************************************0
0**********************************************************************************************************************D***************************0
0********************************************************************************************************************************************D*****0
0**************************************************************************************************************************************************0
0**************************************************************************************************************************************************0
0**************************************************************************************************************************************************0
0**************************************************************************************************************************************************0
0**************************************************************************************************************************************************0
0**************************************************************************************************************************************************0
0**************************************************************************************************************************************************0
0*******************************************bbbb***************************************************************************************************0
0***************************************bbbbbbbb***************************************************************************************************0
0*******************************c******************************************************************************************************************0
0**************************************************************************************************************************************************0
0*****************************bbbbb******************************************************************M*********************************************0
0******s**********************bbbbb***************************c*******bbbbbb************************bbb*********bbb********************c********d**0
0*****************************bbbbb*********************************bbbbbbbb***********M***********bbbb*********bbbb*************M*****************0
0gggggggggggggggggggggggggggggggggggggggggggggggggggggggggggggggggggggggggggggggggggggggggggggggggggggg*********ggggggggggggggggggggggggggggggggggggg
0000000000000000000000000000000000000000000000000000000000000000000000000000000000000000000000000000000*********00000000000000000000000000000000000gg
0**************************************************************************************************************************************************0
0**************************************************************************************************************************************************0
0**************************************************************************************************************************************************0
0**************************************************************************************************************************************************0
0**************************************************************************************************************************************************0
0**************************************************************************************************************************************************0
0**************************************************************************************************************************************************0
