0000000000000000000000000000000000000000000000000000000000000000000000000000000000000000000000000000000000000000000000000000000000000000000000000000
0**************************************************************************************************************************************************0
0**************************************************************************************************************************************************0
0**************************************************************************************************************************************************0
0**************************************************************************************************************************************************0
0**************************************************************************************************************************************************0
0**************************************************************************************A***********************************************************0
0**************************************************************************************************************************************************0
0**************************************************************************************************************************************************0
0*********************************************************************1****************************************************************************0
0*********************************************************************1****************************************************************************0
0*********************************************************************1****************************************************************************0
0*********************************************************************1****************************************************************************0
0*********************************************************************1****************************************************************************0
0*********************************************************************1****************************************************************************0
0************************************************bbbbb****************1****************************************************************************0
0************************************************b***b****************1****************************************************************************0
0************************************************b***b****************1****************************************************************************0
0*****************************bbbbb**************b***b****************1*****************************************************************(*********d0
0******s*******c**************b***b**************b***b****************1**L**************************bbb*********bbb*****************c**************0
0*****************************b***b**************b***b****************1****************************bbbb*********bbbb*******************************0
0gggggggggggggggggggggggggggggggggggggggggggggggggggggggggggggggggggggggggggggggggggggggggggggggggggggg*********ggggggggggggggggggggggggggggggggggggg
0000000000000000000000000000000000000000000000000000000000000000000000000000000000000000000000000000000*********00000000000000000000000000000000000gg
0**************************************************************************************************************************************************0
0**************************************************************************************************************************************************0
0**************************************************************************************************************************************************0
0**************************************************************************************************************************************************0
0**************************************************************************************************************************************************0
0**************************************************************************************************************************************************0
0*******************************************************************************************************00000000***********************************0